                             1                                  1                            1                                                       0
      1                                              !                                                                                               0
                !                     1                                !          !                                                                  0
                                                                                                                                                     0
                                                                                                                                                     0
                                                                                                                                                     0
                                                                                    BBBBBBBBBBB   BBBBBB-                  -                1        0
                                                                                                                                                     0
                CCC                                                                                                                                  0
            _   B-B=B                                                          B+B                      B          BB   -  -  -         S  S         0
#                       P                   P              P                                                 #                         SS  SS      E 0
M           @   3    2      L       L     C       @ K          2  3       2    CCC    L          @     CC         K    3   2 L   3    SSS  SSS  2    0
GGGGGGGGGGGGGGGGGGGGGGGGGGGGGGGGGGGGGGGGGGGGGGGGGGGGGGGGGGGGGGGGGGGGGGGG  GGGGGGGGGGGGGGGGGGGGG  GGGGGGGGGGGGGGGGGGGGGGGGGGGGGGGGGGGGGGGGGGGGGGGGGGGGG
GGGGGGGGGGGGGGGGGGGGGGGGGGGGGGGGGGGGGGGGGGGGGGGGGGGGGGGGGGGGGGGGGGGGGGGG  GGGGGGGGGGGGGGGGGGGGG  GGGGGGGGGGGGGGGGGGGGGGGGGGGGGGGGGGGGGGGGGGGGGGGGGGGGG